
Bestow Ancient Curse			TYPE:Divine	CLASSES:Cleric=9		SCHOOL:Necromancy			COMPS:V, DF, XP	CASTTIME:1 standard action	RANGE:Touch	TARGETAREA:Creature touched		DURATION:Permanent	SAVEINFO:Will negates	SPELLRES:Yes	DESC:You bestow a curse that persists through generations.	SOURCEPAGE:p.	ITEM:Potion		XPCOST:2000						TEMPDESC:The curse persists across the generations.
Bestow Divine Curse			TYPE:Divine	CLASSES:Cleric=7		SCHOOL:Transmutation			COMPS:V, M, DF, PowerCheck	CASTTIME:1 full round	RANGE:Medium	TARGETAREA:One creature		DURATION:Permanent	SAVEINFO:None	SPELLRES:No	DESC:-6 to an ability score; -4 on attack rolls, saves, and checks; or 50%% chance of losing each action.	SOURCEPAGE:p.	ITEM:Potion				TEMPBONUS:PC|SAVE|ALL|-4|TYPE=Temporary	TEMPBONUS:PC|COMBAT|TOHIT|-4|TYPE=Temporary	TEMPBONUS:PC|SKILL|ALL|-4|TYPE=Temporary		TEMPDESC:Applies penalty to attacks, saves, and skill checks.
Borrowed Time				TYPE:Arcane.Divine	CLASSES:Cleric=5|Sorcerer,Wizard=5|Blackguard=4		SCHOOL:Necromancy			COMPS:V, M, PowerCheck	CASTTIME:3 days	RANGE:Personal	TARGETAREA:You		DURATION:See text	SAVEINFO:None	SPELLRES:No	DESC:Animate yourself as one of the undead to complete a specific task.	SOURCEPAGE:p.									
Borrowed Time (Greater)	OUTPUTNAME:Borrowed Time, Greater		TYPE:Arcane.Divine	CLASSES:Cleric=7|Sorcerer,Wizard=7		SCHOOL:Necromancy			COMPS:V, M, PowerCheck	CASTTIME:3 days	RANGE:Personal	TARGETAREA:You		DURATION:See text	SAVEINFO:None	SPELLRES:No	DESC:Animate yourself as one of the undead to complete a specific task.	SOURCEPAGE:p.									
Borrowed Time (Lesser)	OUTPUTNAME:Borrowed Time, Lesser		TYPE:Arcane.Divine	CLASSES:Cleric=3|Sorcerer,Wizard=3|Blackguard=3		SCHOOL:Necromancy			COMPS:V, M, PowerCheck	CASTTIME:3 days	RANGE:Personal	TARGETAREA:You		DURATION:See text	SAVEINFO:None	SPELLRES:No	DESC:Animate yourself as one of the undead to complete a specific task.	SOURCEPAGE:p.									
Feign Undeath				TYPE:Arcane.Divine	CLASSES:Cleric=4|Sorcerer,Wizard=5		SCHOOL:Necromancy			COMPS:V, S, M, PowerCheck	CASTTIME:1 standard action	RANGE:Touch	TARGETAREA:Living creature touched		DURATION:2 minutes/level	SAVEINFO:Will Negates	SPELLRES:Yes	DESC:You may deal your target with the physical aspects of a zombie.	SOURCEPAGE:p.									
Soul Anchor					TYPE:Arcane.Divine	CLASSES:Cleric=5|Sorcerer,Wizard=5		SCHOOL:Abjuration			COMPS:V, S	CASTTIME:1 standard action	RANGE:Touch	TARGETAREA:Creature touched		DURATION: 1 minute/level	SAVEINFO:Will Negates	SPELLRES:Yes	DESC:Bars extradimensional movement.	SOURCEPAGE:p.	ITEM:Potion								
Tomb Ward					TYPE:Divine	CLASSES:Cleric=9		SCHOOL:Abjuration			COMPS:V, S, DF, PowerCheck	CASTTIME:1 day	RANGE:Touch	TARGETAREA:One tomb		DURATION:Permanent	SAVEINFO:None	SPELLRES:No	DESC:Invoke a curse to protect a tomb from defilers.	SOURCEPAGE:p.									
Zone of Deception				TYPE:Divine	CLASSES:Cleric=2		SCHOOL:Enchantment	SUBSCHOOL:Compulsion	DESCRIPTOR:Mind-Affecting	COMPS:V, S, DF	CASTTIME:1 standard action	RANGE:Close	TARGETAREA:20-ft.-radius emanation		DURATION:1 minute/level	SAVEINFO:Will negates	SPELLRES:Yes	DESC:Subjects within range cannot tell the truth.	SOURCEPAGE:p.	ITEM:Potion								
#
Final Rest					TYPE:Divine			SCHOOL:Necromancy			COMPS:V, S, DF	CASTTIME:1 standard action	RANGE:Touch	TARGETAREA:One newly dead body.		DURATION:Permanent	SAVEINFO:Will negates	SPELLRES:No	DESC:It can resist to any attermpt to transformation into an undead creature (including Animate Dead and Create Undead spells and create spawn ability of undead creatures).	SOURCEPAGE:p.

###Block:
Alarm.MOD	CLASSES:Monster Hunter=1	
Chill Touch.MOD	CLASSES:Monster Hunter=1	
Detect Magic.MOD	CLASSES:Monster Hunter=1	
Detect Secret Doors.MOD	CLASSES:Monster Hunter=1	
Detect Undead.MOD	CLASSES:Monster Hunter=1	
Disrupt Undead.MOD	CLASSES:Monster Hunter=1	
Hold Portal.MOD	CLASSES:Monster Hunter=1	
Light.MOD	CLASSES:Monster Hunter=1	
Protection from Chaos.MOD	CLASSES:Monster Hunter=1	
Protection from Evil.MOD	CLASSES:Monster Hunter=1	
Protection from Good.MOD	CLASSES:Monster Hunter=1	
Protection from Law.MOD	CLASSES:Monster Hunter=1	
Read Magic.MOD	CLASSES:Monster Hunter=1	
Resistance.MOD	CLASSES:Monster Hunter=1	
Arcane Lock.MOD	CLASSES:Monster Hunter=2	
Continual Flame.MOD	CLASSES:Monster Hunter=2	
Darkvision.MOD	CLASSES:Monster Hunter=2	
Daze Monster.MOD	CLASSES:Monster Hunter=2	
Expeditious Retreat.MOD	CLASSES:Monster Hunter=2	
Knock.MOD	CLASSES:Monster Hunter=2	
Magic Weapon.MOD	CLASSES:Monster Hunter=2	
See Invisibility.MOD	CLASSES:Monster Hunter=2	
Daylight.MOD	CLASSES:Monster Hunter=3	
Diminish Undead.MOD	CLASSES:Monster Hunter=3	
Dispel Magic.MOD	CLASSES:Monster Hunter=3	
Gentle Repose.MOD	CLASSES:Monster Hunter=3	
Halt Undead.MOD	CLASSES:Monster Hunter=3	
Magic Circle against Chaos.MOD	CLASSES:Monster Hunter=3	
Magic Circle against Evil.MOD	CLASSES:Monster Hunter=3	
Magic Circle against Good.MOD	CLASSES:Monster Hunter=3	
Magic Circle against Law.MOD	CLASSES:Monster Hunter=3	
Tongues.MOD	CLASSES:Monster Hunter=3	
Break Enchantment.MOD	CLASSES:Monster Hunter=4	
Detect Scrying.MOD	CLASSES:Monster Hunter=4	
Heroism.MOD	CLASSES:Monster Hunter=4	
Locate Creature.MOD	CLASSES:Monster Hunter=4	
Remove Curse.MOD	CLASSES:Monster Hunter=4	
Suppress Lycanthropy.MOD	CLASSES:Monster Hunter=4	
Dispel Magic (Greater).MOD	CLASSES:Monster Hunter=5	
Hold Monster.MOD	CLASSES:Monster Hunter=5	
Repulsion.MOD	CLASSES:Monster Hunter=5	
